###################################
# ********************************#
#*##########*#########*############
#*********************************#
####### ########### ######## ######
#******************************** #
#********################*********#
#***********#*****#***************#
#***********#**#**#**#************#
#**************#*****#************#
###################################