###################################
# ***********                     #
# ########## ######### ############
#                                 #
####### ########### ######## ######
#                                 #
#        ################         #
#           #     #               #
#           #  #  #  #            #
#              #     #            #
###################################