###################################
# ********************************#
#*##########*#########*############
#*********************************#
#######*###########*########*######
#*************#********#**********#
#*###############################*#
#*********#***#***#***#***********#
#*********#*#*#*#*#*#*#*#*********#
#***********#***#***#***#*********#
###################################